Program:    MAESPA                                                                          
Control:    Single tree test                                                                
Trees:      Single tree IN 1x1 metre plot.                                                  
Structure:                                                                      Multispecies
Physiology:                                                                     Multispecies
Met data:   Met file for SINGLE TREE IN 4x4                                                 
Water bal.: Example water balance parameters.                                               
                                                                                
DOY: simulation date
Tree: tree number
Spec: tree species number
Hour:  hour of the day
hrPAR: absorbed PAR              umol tree-1 s-1
hrNIR: absorbed NIR              W tree-1
hrTHM: absorbed thermal          W tree-1
hrPS: photosynthesis (net of leaf resp) umol tree-1 s-1
hrRf:  hourly leaf respiration   umol tree-1 s-1
hrRmW: hourly stem + branch Rm   umol tree-1 s-1
hrLE:  hourly transpiration      mmol tree-1 s-1
LECAN: hourly transpirn: CANOPY calc : mmol H2O m-2 s-1
Gscan: canopy stomatal conductance : mol CO2 tree-1 s-1
Gbhcan: canopy boundary layer conductance to heat : mol tree-1 s-1
hrH:   hourly sensible heat flux:  MJ tree-1 s-1
TCAN: Average foliage temperature (deg C)
ALMAX: Canopy maximum leaf photosynthesis rate (umol m-2 s-1)
PSIL: Canopy average leaf water potential (MPa)
PSILMIN: Canopy minimum leaf water potential (MPa)
CI : Canopy average intercellular CO2 conc. (ppm)
TAIR: Air temperature (deg C)
VPD: vapor pressure deficit (kPa)
PAR: Above-canopy incident PAR (umol m-2 s-1)
ZEN: Zenithal angle (rad)
AZ: Asimutal angle (rad)
                                                                                
Columns: DOY Tree Spec HOUR hrPAR hrNIR hrTHM hrPs hrRf hrRmW hrLE LECAN Gscan Gbhcan hrH TCAN ALMAX PSIL PSILMIN CI TAIR VPD PAR ZEN AZ
